NO    ./img/AnyConv.com__eagle.xpm

WE   ./img/AnyConv.com__eagle.xpm

SO     ./img/AnyConv.com__eagle.xpm

EA        ./img/AnyConv.com__eagle.xpm





C       225,30,011

F       220,100,011


1111111111
1        1111111111111111111111111111111111
10000000110000000000001
1011000001110000000000001
10010000000000000000000011111111
111111111011000001110000000000001
100000000011000001110111111111111
111101111111110111000010001
11110111111111011101010010001
110000001101010111N00000010001
1000000000000001100001010001
10000000000000001101010010001
110000011101010111110111100111
11110111 1110101 101111010001
11111111 1111111 111111111111